––––––––––––––
––––––––––––––
–––––––––T––––
–––––––ooo–o––
–––––––o.ooo––
––ooooooooo–––
–ooo.ooooo––––
–ooo.oo–––––––
–ooooo––––––––
––––oo––––––––
––––o–––––––––
––––S–––––––––
––––––––––––––
––––––––––––––
