--------------
--ooo---------
--oSo---------
--ooo---------
---o----------
---o----------
---o----------
---o----------
--ooo-----ooo-
--oooooooooTo-
--ooo-----ooo-
--------------
--------------
--------------