--------------
--------------
--------------
--------------
--S--oo-------
--o--ooo------
--oo-oooo-----
--oooo-ooo----
-------ooT----
--------------
--------------
--------------
--------------
--------------