--------------
--S--oo-------
--o--ooo------
--oo-oooo-----
--oooo-ooo----
-------ooo----
--ooo----o----
--ooT----o----
---oo--ooo----
---oooooo-----
--------------
--------------
--------------
--------------