--------------
--------------
--------------
--------------
-oo.o.--------
-o.S....------
-oo..o.oooo---
--.o....oooo--
--------...oo-
--------ooo---
----------To--
---------ooo--
--------------
--------------