––––––––––––––
––––––––––––––
––––S–––––––––
––––o–––––––––
––––oo––––––––
–ooooo––––––––
–ooo.oo–––––––
–ooo.ooooo––––
––ooooooooo–––
–––––––o.ooo––
–––––––ooo–o––
–––––––––T––––
––––––––––––––
––––––––––––––
