--------------
---ooo--------
---oSoo-------
--ooooo-------
--ooo.o.-o----
---ooo..-ooo--
----....--ooo-
-----.....ooo-
------..ooooo-
--------oooo--
--------ooo---
--------oTo---
---------o----
--------------