––––––––––––––
––––––––––––––
–––––––––TS–––
––––––––––––––
–––––––o.ooo––
––ooooooooo–––
–ooo.ooooo––––
–ooo.oo–––––––
–ooooo––––––––
––––oo––––––––
––––o–––––––––
––––o–––––––––
––––––––––––––
––––––––––––––
