--------------
----o---------
---oTo--------
---ooo--------
--oooo--------
-ooooooo------
-ooo.....-----
-ooo.....o----
--ooo-.oooo---
----o-.o.ooo--
------.ooooo--
-------ooSo---
--------ooo---
--------------