––––––––––––––
––––––––––––––
––––––––––––––
–ooo––––––––––
–oSo––––––––––
–oo––..o...–––
–oooo..–..o–––
–––––––––oo–––
––––––––..T–––
––––––––oooo––
––––––––––––––
––––––––––––––
––––––––––––––
––––––––––––––