--------------
---ooo--------
---oSoo-------
--ooooo.------
--ooo.o.-o----
---oooo.-ooo--
----o.....ooo-
-----.....ooo-
------ooooooo-
--------oooo--
--------ooo---
--------oTo---
---------o----
--------------